@ @@@@@@@@@@@@@
@                 @
@ @@@@@@@@@@@@@
@                 @
@ @@@@@@@@@@@@@
@                 @
@ @@@@@@@@@@@@@
@                 @
@ @@@@@@@@@@@@@
@                 @  
@ @@@@@@@@@@@@@
@                 @
@ @@@@@@@@@@@@@
@                 @
@ @@@@@@@@@@@@@